XXXXXXXXXXXXXXXXXXXX
X         E       XX
X                 XX
X         XXXXX    X
X                  X
X                  X
X    XXXXX         X
X                  X
X                  X
X        XXXXXX    X
X                  X
X                  X
X      S           X
X     XXXX         X
X                  X
X                  X
X                  X
X                  X
X                  X
XXXXXXXXXXXXXXXXXXXX
