XXXXXXXXXXXXXXXXXXXX
X    E             X
X            SX    X
X0000XXX     X     X
X0000              X
X0000              X
X0000              X
X0000              X
XXXXXXXX           X
XXXXXXXX           X
XXXXXXXX           X
XXXXXXXX           X
XXXXXXXX           X
XXXXXXXX           X
XXXXXXXX           X
XXXXXXXX           X
XXXXXXXX           X
XXXXXXXX           X
XXXXXXXX           X
XXXXXXXXXXXXXXXXXXXX
